Abbr : abbreviation
	 Yes : it is abbreviation
Animacy : animacy
	 Anim : animate
	 Inan : inanimate
	 Hum : human
	 Nhum : non-human
Aspect : aspect
	 Imp : imperfect aspect
	 Perf : perfect aspect
	 Prog : progressive aspect
	 Hab : habitual aspect
	 Rapid : rapid sudden action
	 Dur : durative aspect
	 Prosp : prospective aspect
Case : case
	 Nom : nominative / direct
	 Acc : accusative
	 Dat : dative
	 Gen : genitive
	 Loc : locative
	 Ins : instrumental
	 Abl : ablative
	 Equ : equative
Definite : definiteness or state
	 Ind : indefinite
	 Def : definite
Degree : degree of comparison
	 Cmp : comparative, second degree
	 Sup : superlative, third degree
Evident : evidentiality
	 Fh : firsthand
	 Nfh : non-firsthand
Gender : gender
	 Masc : masculine gender
	 Fem : feminine gender
	 Neut : neuter gender
	 Com : common gender
Mood : mood
	 Ind : indicative
	 Gen : generalized modality
	 Imp : imperative
	 Prs : persuasive
	 Opt : optative
	 Nec : necessitative
	 NecPot : necessitative potential
	 GenNec : general or hypothetical necessitative
	 GenNecPot : general or hypothetical necessitative potential
	 Pot : potential
	 PotPot : potential expressed twice
	 GenPot : general or hypothetical potential
	 GenPotPot : generallized modality and potential expressed twice
	 CndGenPot : conditional predicate with generallized modality and potential
	 Cnd : conditional
	 CndGen : general (non-past) conditional
	 CndPot : conditional potential
	 Des : desiderative
	 DesPot : desiderative potential
Number : number
	 Sing : singular number
	 Plur : plural number
NumType : numeral type
	 Card : cardinal number or corresponding interrogative
	 Ord : ordinal number or corresponding interrogative
	 Dist : distributive numeral
Person : person
	 1 : first person
	 2 : second person
	 3 : third person
Polarity : polarity
	 Pos : positive
	 Neg : negative
Poss : possessive
	 Yes : it is possessive
PronType : pronominal type
	 Prs : personal
	 Rcp : reciprocal pronoun
	 Int : interrogative pronoun, determiner, numeral or adverb
	 Dem : demonstrative pronoun
	 Ind : indefinite pronoun
	 Loc : locative pronoun
	 Neg : negative determiner or pronoun
	 Art : article
Reflex : reflexive
	 Yes : it is reflexive
Tense : tense
	 Past : past tense
	 Fut : future tense
	 Pres : present tense
	 Pqp : pluperfect
VerbForm : verb form
	 Conv : converb
	 Fin : finite verb
	 Part : participle
	 Vnoun : verbal noun
Voice : voice
	 Pass : passive voice
	 PassPass : double passive voice
	 PassRfl : combination of passive and reflexive voices
	 PassRcp : combination of passive and reciprocal voices
	 Rcp : reciprocal voice
	 Cau : causative voice
	 CauCau : double causative voice
	 CauPass : passive causative voice
	 CauCauPass : passive causative causative voice
	 CauRcp : causative reciprocal voice
	 CauPassRcp : causative reciprocal passive voice
	 Rfl : reflexive voice
